####################
#       # #       ##
####### # # ##### ##
#     # o o # #   ##
# ####### # # ###G##
#     C # #     # ##
# ##### # ####### ##
# #   #         o C#
### # #       ### ##
# o  G         G# ##
# ### #   S  ## # ##
#     o       G # ##
##### #      ####C##
#   #       #     ##
# ###########o######
# C         CC  o ##
# # #####o####### ##
#       #         ##
##C#################
####################
