####################
#   #   #   #    C##
### #C#C# # ### # ##
# # #   G # #   #C##
# # ###o### # ### ##
#   # C #   # #   ##
# ### ##### # ######
#   #         o   ##
### # #      ## # ##
# #G#         # # ##
# # # #   S   # # C#
# # # #      G# # ##
# # ###      #### ##
# # #   # # #     ##
# # # ### # ### #C##
#G  #   # #     # ##
# ### # #C##C#### ##
#   o   #         ##
####################
####################
