##########
# G   # ##
##### # ##
# o # # ##
# #   # ##
# #  SGG##
# ##### ##
#  G    ##
#C########
##########
