##########
# # G   ##
# #G### ##
# # #  C##
# #   ####
#  G S#G##
##### # ##
#     oG##
##########
##########
