####################
#     #           ##
##### ### ###o######
# # #  C# # #     ##
# # ### # # ##### ##
# o o # # #       ##
#o# # #C###o########
# #   #           ##
# ### #      #### ##
# #   C         # ##
# #C###   S  ## # ##
#   #         # # ##
###o# #       C C ##
#   # # # # #   # ##
# ### # # # ##### ##
# #  G#   #  C    ##
# #o###o### ##### ##
#        G  #     ##
##############C###C#
####################
