####################
# #             o ##
# # ####### C####C##
# o     # # #  G# ##
### ### #G# # ### ##
# #   # # # #     ##
# ### # #o# ####C###
# C # #           ##
# # # #      ##o# ##
# # # #       # # ##
### # #   S   # #o##
#   CG        # # ##
# #####      ## # ##
# o   #   #   C # ##
# # ############# ##
# #     #   C     ##
# #####o# # # ######
#   CG#   #       ##
####################
####################
