##########
# #     ##
# ### # ##
#   # C ##
###   #G##
# #  SG ##
# #####G##
#  G  G ##
##########
##########
