####################
#   #           o ##
### ### ######### ##
#   #   #     #   ##
# ### ### ### ### ##
#     #   #G#   # ##
####### ### #GC## ##
# #          G#   ##
# # ###      ## ####
#               # ##
# #####   S   ### ##
# #           #   ##
# # # #      #### ##
# # # #       #   ##
### # # ### # # ####
#   # # # #   #   ##
# #o### # ##### # ##
# #           o  G##
####################
####################
