####################
#       o  Co #   ##
######### # #####o##
#     G # # #     ##
# ###o### ##### # ##
# # #     C     # ##
# # ####### ########
#   # #           ##
### # #       ### ##
#C# #         #   ##
#C# ###   S   # # ##
# # #         # # ##
# # ###      ## # ##
#C#     #     # # ##
#C##### #o### # # ##
#   o # G #G# #  G##
# # #CC#### C ###o##
# # #             ##
###########C########
####################
