###################################################################################################
#   #     #       #                             #     #                   #   #       #         # #
### # # # ##### ### # ######################### ### # ### ######### ##### # # # ##### # ### ### # #
# # # # #       #   #     #   #       #           # #   #   #     # #   # # # # # #   # #   # #   #
# # # # ####### # ####### # # # ##### # ######### # ### ### ##### # # # # ### # # # # # # ### ### #
# # # # #       # #     #   #     #   # #     # # #   #   #       # # # #   #     # # # #   #   # #
# # # # # ####### ##### ######### # ### # ### # # ### ### ### ##### # # ### ####### ### ### # ### #
#   # # # #     #     #   #   #   # #   #   # # #     # # #   #     # #   #       #     #   # #   #
# ### # # ### ####### # ### # ##### ##### ### # ####### # ##### ##### ### ####### # ##### ### # ###
# #   # #     #       #   # # #   #     # #   #         #     # #   #   #     #   #     #   #   # #
# # ### ### ### ######### # # # # ##### # # ##### ### # ##### # # ### # ##### # ########### # ### #
# #   # #   #   #     #   # # # #     #   #     # # # #   #   # #     # #     #       #     #     #
# ### # ##### ##### # # # # # # ##### ######### # # # ##### ### ####### ##### ####### # ######### #
#   # #     #       # # # # #   #   #         # # # #           #   #   #   #   #   # # #       # #
### ####### ######### # # # ##### # ######### # # # ############# # # ### # ##### # # # # ### ### #
# #   #   # #     #   # # #       #   #   #     # #   #   #   #   # # #   # #     # #   #   # #   #
# ### # # # # # ### ### # ########### # # ####### ### # # # # # ### # # ### # ##### ####### # # ###
#   #   # # # #     #   # #         # # #   #         # #   #     # #     #   #   #     #   # # # #
### ##### # # ####### ### ### # ##### # ### ######### # ########### # ####### # # ### # # ### # # #
#   #     # # # #     # #   # #   #   # # #     #     # #     #     # #     # # # #   #   #   # # #
# ### ##### # # # # ### ### # ### # ### # ##### ####### ##### # ####### ### # # # # ########### # #
# #   #   #   #   # #   #   #   # # #   #     #         #     #         #   # # # #           # # #
# # ### ### ####### # # # ##### # # # ### ############### ### ########### ### # # # ######### # # #
# # #       #       # # # #     # #   # #             #   #   #       #   #   # # # #       #   # #
# # # ######### ##### # # ##### # ##### # ##### # ### ### ##### # ### # ####### # # ####### ##### #
#   #     #     #     # #     # #         #   # # # #   #       # #   #         # #   #     #   # #
# ####### # ######### ####### ############# # ### # ### ######### ############### ### # ### # # # #
# #       #   #       #     #   #     #     #     #   #     #   #           #     #   # # #   #   #
# ### ####### # ####### ### ### # ### # ########### ####### # # ####### ### # ####### # # ####### #
#   #     #   #           #   #   # # # #   #     #     #   # #     #   # # #       # # #       # #
### ##### # ### ######### ### ##### # # ### # # # # # ### ### ##### # ### # ####### # # ### ##### #
#   #   # #   #     #   # #     #     #   #   # # # #     #   #       #   # # #     # #   #       #
# ##### # # # ##### # # ### ##### ####### # ### # # ####### # ######### # # # # ##### # # # #######
#     #   # #   #   # #   #               #   # # # #       # #       # #     # #     # # #       #
##### # ####### # ### ### ########                                ### ####### # ##### ### #########
#   # #   #     #   #   #                                         # #     # # #     #   # #       #
# # # ### # ####### ### #########                                 # ##### # # ##### ### # # ##### #
# # # # # #   #     # # #       #                                 #   #   #   # #   # # # #     # #
# # # # # ### # ##### # ##### ###                                 # ### ### ### # ### # # ### ### #
# #   #       #       #     #                                     #   #   # #   # #       #   #   #
# ############### ####### # ### ##                                # # ### # # # # ### ##### ### # #
#           #   # #     # #   #                                   # #   # #   # #   # # #   # # # #
########### # # # # ### ##### ###                                 # ### # ####### # # # # ### # ###
# #     # # # #   #   #   #   #                                   # # # #       # # #   #     #   #
# # # # # # ### ##### ### # ### ##                                # # # ####### # # ##### ####### #
#   # #   #   #     # # # # # #                                   #   #       # # # #     #       #
# ### ####### ####### # # # # ###                                 ### # ### ### # # # ##### #######
#   #         #       # #   #   #                                   # #   # #   # # # #   # #     #
### ########### ####### ##### # ##                                ### ### ### ### # # # # # # ### #
# # #     #     # #     #     # #                                   # # # #   # # # #   # #     # #
# # # ### # ##### # # ### ### # #                                 # # # # # ### # # ##### ####### #
# #   #   #   # #   #     # # # #                                 #     #   # #   #           #   #
# ##### ##### # # ######### # ###                                 ##### ##### # ############### # #
#     #   #   #   #       # #   #                                   #   #   #       #     #     # #
# ### ### # ### ### ##### # ### #                                 # # ### # ######### ### # ##### #
#   #   #   # # #     #   #   # #                                 # #     #     #     # # #   # # #
####### ##### # # ### # ### # # ##                                # ########### # ##### # ### # # #
#   #     # #   # # # #     # #                                   # #       # # # # #     #   #   #
# # # ### # # ### # # ### ########                                # # ##### # # # # # ##### ### ###
# # # # #   #   # # #   # #     #                                 # #     #   #   # #     # #   # #
# # # # ### ### # # ### ### ### #                                 # ##### ######### ##### # # ### #
# # # #   #   # #   # # #   # #                                     #   #       #   #   #   #     #
# # # # # ### # ### # # # ### ####                                ### # ##### # # # # ########### #
# #   # #   # # # # # #   #   #                                   #   #       #   #   #           #
# ####### # # # # # # ##### # # #                                 ### ############### # ###########
#       # # # # #     #     # # #                                   # #     #         #   #       #
# ##### # # # # ##### ### ### # ####### ### ######### ##### ####### # # ### ##### ####### ### ### #
#   #   # #   #   #   #   #     #       # #       # # #   # #       # # #   #   #   #   #   #   # #
### # ### ####### # ### ##### ### ####### ####### # # # # # # ####### # # ### # ##### # ### # ### #
#   # #         # # #   #   # #   #     #       # #   # # # #   #   #   #   # #     # #     # #   #
# ### ########### # # ### # ### ### # ### ### # # ##### # # ### # ### ##### # ##### # ######### # #
# # #           # #   #   # #   # # #   # # # # #     # # # #   #     #   #   #     # #         # #
# # ########### # # ### ### # ### # ### # # # ####### # # ### ### ####### ##### ##### # ### ##### #
# #     #     #   # #   #   #   #   #   # # #       #   #     # #     #   #   #       #   # #     #
# # ### ##### ##### # ### ##### ##### # # # ##### # ########### ##### # ### # ########### # #######
#   #   #   #       # #         #     # # # #   # #           #   #   #     #       #   # #       #
##### ### # ######### ########### ####### # # # ############# # # # ############# # ### # ####### #
#   #   # #         #   # #             # # # # #     #     #   # # #     #       # #   #     # # #
# # ### # ######### ### # # ########### # # # # # ### # ### ##### # # ### # ####### # ####### # # #
# #   # #     #     #   # # #   #   #   # # # #   #     #         # # # #   #       #     #     # #
# ### # # ### # ##### ### # # # # # # ### # # ### ####### ######### # # ##### ####### ### # ##### #
#   # # # #   # #     #   # # # # # #       # #   #     # #       #   #     #     # # # #   #     #
### # # ### ### # ### # # # # # ### ######### # ### ### # # ##### ##### ######### # # # ##### ### #
#   # #     #   # #   # # #   # #     #       #   #   # # #     #     #           #     #     # # #
# ########### ##### ### ####### # ### # ####### ##### # ####### # ##### ########### ##### ##### # #
# #         #     # # #       #   #   #     # # #     #       # #   #   #     #   # #     # #     #
# # # ########### # # # ### # ##### ####### # # # ######### ### ### # ### ### # # # # ##### # #####
# # # #           # #     # #     #   # #   #   #     #   #       # # #   #   # # # # #   #   #   #
# # # # ########### ##### # ######### # # ### ####### # # ######### # ##### ### # # # # # # ##### #
# # #   #   #       #   # #         # # # #         #   # #     #   # #   #     #   #   # # #     #
# # ##### # # # ##### # ### ####### # # # ### ########### # ### # ### # # ######### ##### # # ### #
#   #     # # # #     #   #     #   #   #   # #       #   #   # # #   # # #       #     # #   # # #
# ### ##### # # # ####### ##### # ##### ### ### ##### # ##### # # # ### # # ##### ####### ##### # #
# #   # #   # #     #     #   # # #   #   #     #   #     #   #   #     #   #   # #       #       #
# # # # # ######### # ##### ### # # # ### ######### ####### ##### ########### # # # ####### #######
# # # # #       #   # #         #   # #   #         # #     #         #       # #   #     #     # #
# ### # ####### ##### # ############# # ##### ##### # # ############### ### ######### ### ##### # #
#     #               #             #         #       #                   #             #         #
###################################################################################################
