####################
#   #     #       ##
### #o### # ### # ##
# # # #   C #   # ##
#C# # ### ##C ### ##
#   #C  #G#  G#   ##
# ### # # # ###C####
# #   #       #   ##
# ### #       # # ##
#   # #         # ##
### # #   S  C###C##
# # #G            ##
# # ###       ##C###
# #C  # #   # #  G##
# ### ### ### # # ##
#   #   o     # # ##
# ####### ##### ####
#          C  o oG##
####################
####################
