####################
# #             # ##
# ##### ####### # ##
# C   # #       # ##
#####o# ##### #C# ##
# o   #     #G Co ##
#C# # ##### #####C##
# # #         #   ##
### # #       # ####
# # #G        # # ##
# # ##C   S  ## # ##
#   #         # # ##
#G### #      o# #o##
#   # #     # #   ##
# # # ##### # ### ##
# # #    G# #   # ##
# #C##### # ##### ##
# #       #       C#
####################
####################
