####################
# #   #  C    #   ##
# ###o# ##### # ####
# #   # # #   #   ##
# # ### CC# ### # ##
# #       # #   # ##
# # #######G# ### ##
# o           #   ##
### ###       # # ##
# #   C       # # ##
#C#####   S  ## ####
#   #           o ##
# # # #       # # ##
#C# o #G        # ##
# # ############# ##
# #             # ##
# #############o# ##
# o   o         oG##
###########C####CC##
####################
