####################
# #     #   o     ##
# # ####### ##### ##
# # #   #   #     ##
# # #o#G# ### ### ##
# C   #     # # o ##
# # #####C### C ####
#C# #         #   ##
# ### #       ###o##
#   oC#       #   ##
##### #   S   ###o##
#   # o         # ##
### ###      ## # ##
#   #   G #   # # ##
# ### ####### # # ##
#    G#   G   # #C##
# ###o# ##C#### ####
#   #     o   o   ##
####C###############
####################
