####################
# #       #     # ##
# ##### # ### # # ##
#       #     # # ##
############### # ##
#G#C    #     # # ##
# # # # # ### # # ##
#   # #       # # ##
##### #       # # ##
#     #       #   ##
# #####   S  #### ##
# o   G         # ##
# #####       # # ##
# #G    o # #G# # ##
# # ### ### # ### ##
# # #   #   #   # ##
# # # ##### ### # ##
#   #     o   #   ##
####################
####################
