###################################################################################################
# #       #           o   #         # #     #                 #     #         #         # #       #
#o# ##### ##### ### # # ### ###o# # # # ### # ####### ####### # ###o# # ####### ##### # # # ##### #
#     # #     #   # # #   #   # # # o   #   # #     #  C    # #   # # # o     # #   # #  C# #   # #
#o# # # ##### ### # # ### ### # # ####### ### # ### # ##### ##### # # # ##### # # ### ##### # # # #
#   # #     #   # #     #   # # #     #   #   # # # #   #   o #   #   #     #   #   #   #   # # # #
# ###o##### ### # ####### ### # ### # ##### ### # # # ### # # # ####### ### ##### # ### # ##### # #
#   o   #     # #     #   o       # # #     #   # # # # o   # # #       # # #   # # #   #   #   # #
### ##### ##### # ####### #####o# # # # ##### ###o#o### # ### # ###o##### # # # # # # ##### # ### #
#       #       # #  G# # #     # # # # # #   # #     # #   # #     #     # # #     #   #   #   # #
### ### # ######### # # # # ##### ### # # # ### # ##### ### #o####### ##### # ###o##### #o##### # #
# o     #     #     # #   # #   #   # #   # #   #       # # #     #     #   # # o   # o #     o o #
# # ######### ### ### # ### ### ### # # ### # ########### # # # ### ### # ##### # ### ######### #o#
# # #     # #   # # o     #   #   # #   #   #     #       # # #       #   o     #   #       #   # #
# # #o### # ### # # ##### ### #o# # # ### ##### # # ### ###o# ####### ############### #####o# ### #
# #   #     # # #     #     # # #   #   #   #   #   #   #     #   # # # #     #   o #     #     # #
# ##### ### # # #o### ##### # # ####### ### # ##### ##### ##### # # # # # ### # ### ######### ### #
#     # # #   #   # # #   # # #     # o # o   #   # #   #   #   # #     # # # # # # #       # #   #
# ### ### ### ##### # # # ### ##### # ### # #####o### # ### # ### ####### # # # # # # ##### ### # #
# #   o   o # #     #   #   # o   # #   # # #     o   #   # # #   #     # #   #   #   #   #   # # #
# # # ##### # ### # ####### # ### # ##### # # ### ####### # # # ### ### # # #####o##### ##### # ###
# # #   #   #   # #     #   #     # #     # #   # o   #   # o #   #   o # # #     #   o #     #   #
# # ### # ##### # # ### # ###o##### # ##### ### ### ### # ### ### #o# ### # C ##### #####o####### #
# # #   #     # # # # # #     # #   # #           #   # #     #   # #     #   #   o   #           #
###o# # ##### # ### # # ####### # ### # ######### ### # ##### # ### ############### # #o### ### ###
#     # o   # #   o   #   #     # #   # #       #     #   #   # # o   #     #     # #     #   #   #
# # ##### # # ##### # # ### # ### #o# ### ##### #####o### ##### # ######### # ### ### # # ### ### #
#   # o   # #   #   #   o   #     # #         #   #   # #   #   # #       # #   #     o o # o #   #
##### # # # ### ##### # ########### ### #o### ### ##### ### # ### # # ### # ### ##### # ### ### # #
#     #   #   # #   # # #       # # # o   #     # #   o   # # #   # #   #     # #     #   #   # # #
# ########### # # # ### # ##### # # ###o### # ### # ##### # # ### # ### ### ### #o####### ### # ###
#     #     # #   #   o # #   # #   #   #   # #   # #   # # # #   #   # #   #   #   #   #   # #   #
##### # # ### ####### ### # # # ##### ###o##### ### ### # # # # ####### # ### ##### # ##### # ### #
#     # #   # #     # #     #       # # # #     #     #     #   #     #   #   #     # #     # #   #
# # #o# ### # ##### ##### ###o####                                ### #o# # ### ##### # ####### # #
#   #   # # #       #   #   #   #                                 #   # # #   # o o #   # # #   # #
# ####### # ####### # # ### ### #                                 # ### # ### ### # # ### # # ###o#
# #   #   #     # #   # #   #   #                                 #   o     # #   # #   o   # #   #
# # #o#o# ### # # ##### ##### ###                                 ######### #o### # ##### ### # # #
#   #   # #   #   # #   #     # #                                       #   o   #   o   #     # # #
##### # ### ##### # # ### ##### #                                 ##### # # ########### #o##### # #
# #     #   #       # #   #     o                                     #   # # #         #         #
# # #######o#o####### ### # # # ##                                ### ##### # # # ####### #########
# # # #     #   #     #   #   #                                     o   # o #   # #   o #     # o #
# # # # ##### ### ##### ###o#####                                 ##### # ####### # # # ##### # # #
#     #   #   #   #   o #       #                                 #     #     #   # o # #     # # #
######### # ### ### C## #o### # #                                 # ######### # ##### # # ##### # #
#         # # # # o #     #   # #                                 #       #   # #     # #   # o # #
# ######### # # # # C ###o# ######                                #######o### # # ##### ### # # # #
# #     # # o # # #   # # # #                    S                o         #   # #   o o # # # # #
# # ### # #o### # ### #o### # ####                                ##### ### ##### # ### ### ### # #
# # # # #   #   #       o #     #                                 #   #     #   # #   #   # #   # #
# # # # # ### ### ####### ##### ##                                # # ####### # #o### #####o# #####
# #   #   o # #     #   #   #   #                                 # #         #     #     #       #
# ### ### # # ####### # ### # ###                                 ##### ##### ##### ##### # # ### #
# #   #G# # #       # #     # #                                   #   # #   # #   # #   #   # #   #
# #o### # # ####### # ####### ###                                 # # # # # # # # # # # ##### # # #
#   #   # #       #   # #   # #                                   # # #   # #   # o # #       # # #
#o# # # #o####### ##### # # # # #                                 # # #####o##### ##### ### ### # #
# # # #     o   #   o   # # # # #                                 o   #   #   #     # o   # #   # #
# # ### # # ##### # ### # # # # ##                                # ### # ##### # # # ### ### ### #
# #   #   # #     # #     # #   #                                 # #   #   #   # # o   #   #   # #
# ### ####### ##### # #o# # ### #                                 # # #####o# # # ######### ### # #
#     #     #       # # # #                                       #   # #     # #   # #         # #
# ##### ### ####### # # # ########                                ##### #o### ##### # # ###########
# #   # #         # # #   #   #                                       #     # #   o #   # #       #
# # # # ######### # # #o# ### # ##### ##### # ### # ##### ### # ### # ##### # # # ### ### # ##### #
#   # #       # # # # # #   # # #   #   #   # # # #   o #   # # #   # # #   #   o # # #   #   # # #
##### ####### # # # #o# ### # # # ##### # # # # # ##### ### # # # ### # # ######### # # #o### # # #
# #   #     # # # # # # #     # #     #   # # # #     #   #   # # #     # o     #   o   #     #   #
# # ### ### # # # ###o# # ##### ### ####### # # ##### #o### #o# # ######### ### ### #########o# ###
# #   # # #   # #   # # # #   #   # #       #     # #   o   # # #   #     # # # #     #       #   #
# ###o# # #####o### # # ### # # # # # ########### # ### ##### # ### # ### ### # ####### ######### #
#     # #   o   # # o   #   # # # # #           #   #   #   #   #   o #   # #   #     #       #   #
# ### # # # # # # ### ### ###o### #o### ###########o#o### ####### ##### # # # ### ### # ###o# # ###
# #   # # # #       #     #       #     #       #             #   #     #   #     # # # #   #   # #
# # ### ### ####### ####### ########### #o##### # # ### ### # # ### ##### ######### #o### ### ### #
#   #   #   #   # #         #     #     #     # # #   # #   #   #   #     #       #       # #     #
##### ### #o# # # # ####### # ### #o###o# ### # ##### #o# ####### ####### # ### ### ### ### ##### #
#     #   #   # #   #   #   # # #   #   # #   #       #           o o   # #   #   # #   # o o   # #
# # #####o##### # ###o# ##### # ### # ##### ########### ### ### ### ### ##### ### # # ### # # # # #
# # #   #       #     #       # o   #   #   #   #   # #   # #   #   #   #     # # #   # oC# # o # #
# ### # ### #o# ##### #########o# ##### # ### # # #o# ### ### # ##### # # #####o# ##### # # #####o#
#     #   # # # #     # # #     #     #   #   # # #     #     # #     # #     o #       # # o   # #
######### ### ### ##### # # ##### # ######### # # ######### ##### ############# ##### # # # ### # #
#   #   # # o   # #   o #       # #     #     #   #         #     # #         #   #   o # C # #   #
# # # #o# # # ### # ### # #o###o# ### # # ### ##### ######### ##### # ####### ### #o# ####### ### #
# #   # # # #   # # #   # #   #   # o   # #   #   #     #   #       #     o #   #     #     #     #
# ##### # # ##### # # ####### # ### ### # # ### # ##### ### ### ###o####### ### ### ### ### # ### #
# #     #   o #   # #G      # #   #       #   # # #   #     # o   # o     #   #   # # o   # # o # #
# ### ##### # # ### # ##### # ### #####o####### # # # ##### # # # # # # # ### # ### # # # # ### # #
#   #       # # #   # #   #   # #       #   #   # # #     # # # #   # # #   # #   #   # o   #   # #
# # ####C#### # #o##### # ##### ##### ### # # ### # #####o# # ####### # #####o### ####### ### ### #
# #     # #   # #     # #   #    C#   #   #   o   #   # # # #     o #   #   #   #       #     # # #
# ##### # # ### # ### # ### ##### # ### #####o####### # # # ##### # ##### # # ##### ########### # #
#     #   #     # # # #     o   #   # #     #     #   # # #   #   # # #   # # #   #           # o #
##### ###o####### # # ##### ### ### # ##### ##### # ### # ### ### # # #o### # ### ####### ##### ###
#   o   #           #       #   o   o   o       #       #         #       #         o   #         #
###################################################################################################
