####################################################################################################
# #   o           #   #     #   #           #   #             #   #       o   #   #   o     #   o ##
# # ### ##### # # # # #o### #o# ######### # # ### ###o####### ### ####### # ### # #o# ##### # ### ##
# #   #     # # #   # #   #   #   #       #   #   # #     #     o        C# #   # #   #   #   #   ##
# # # ##### ### #####o### ####### # ##### #####o### ##### ################# ### # ##### #o# ### ####
# # # #   # # o     #   #       #   #   # #       #     #   #       #     #     #   #   #     #   ##
# ### ### # # # ### #o##### ### ##### # # # ### ###o### # # # ##### # ### ######### # ### ##### # ##
#   o   # #   #   # #     #   # #     #   # # # #   # # #   #     # #   # #   # o #   # #     # # ##
######### ####### # # ### ### # ### ####### # ### ### # #o##### ### ### # # ###C# ##### ##### # # ##
#     o o       #   #   # # # #   #   #     #   # #     # #   # #   o   #   o   #     #     # # # ##
# ### # ####### ##### ###o# # ### ##### ##### # # ### ### # # # ########### #o# ### ### # ### ### ##
# #   #   #     # o   #     # # #       #     C #   #     # #   #   o       # #   # #   #   #   # ##
### ###o### ##### # ### ### # # ########### ### #o######### ##### ### ####### # #o# # ##### ### # ##
#   # #   # o   # #   #   #       o   #     # # # #       #   #   #     #   # # # # # #   # #   # ##
# ### # # ### #o##### ### ######### # # ##### # # #####o##### ### # ##### # # # # # # # ### # ###o##
#   # # #   #       #   #     #     #   #     # #     #       #   #   #   # # # #   # #   #   #   ##
### # # ###o# # ### # ####### ########### # ### ##### #o####### #########o# # ####### # # ##### ####
#   #   # # # # o #   #     #     # #     #   o #     #     #   #     # # # o #   #   # #     o   ##
# ##### # # # # ##### # ###o##### # # ####### ### ##### # # # ### ### # # ##### # # ##### # ### ####
#     #   #   # # #   # o #       # # #     #   # # #   #     #   # # #   o     # #     # #       ##
# ### ########### # ##### ######### #o##### ##### # # #####o# # ### # # ######### ##### # ###o###o##
#   # #       # o # #   # #   #     o   #   # # o   #   #   # # #     o o   #   #     # # #   #   ##
### # # ##### # ### # # # #o### ##### # # #o# # ### ### # #####o# ### # ### # # ### # # ### ### # ##
#   #       #       # #   # #   # #   #   #     o #   # #     # # o #   # # # #   # # #     #   # ##
### ##### #####o### # ##### # ### # ### ######### # # # ##### # ### ### # # # ### # ######### ######
# o   #   #   #   # # #   #   #   # #   #         # # #     #       # # o   o   # #         #   # ##
# ###o# ### # ### ### # ### ##### # # ### ######### # ##### ######### # ######### ######### ### # ##
#   #   #   #     #   #     #     #   #   o     #   # #   #     #     # #       #   #         # # ##
# # # ### ####### # ### ##### ### ####### ##### ##### # # #####o# ### # # ##### ### # ######### # ##
# # #     # #     # #     #   # #   #       # # #   o #C# #         # # #   #       # #         # ##
# # # #o### # ##### ##### # ### ### ### ### # # # ##### # ##### # # ### ### # ####### # ######### ##
# #   #   #     # #     #   #           #   o # # #     #     # # #     # # # #   #   # #         ##
# ####### ##### # ##### ##### ############### # # # #######o### # ### ### # ### # # ###o#####o### ##
#   #     o #       # #   #   #             # # # # #       o   # # #   # # #   # # #       # #   ##
### # ###o# ####### # ### ##### ##                                # ### # # # ### # ####### # # # ##
#   # #   #     # # #   #     #                                   o   #   #   o     #   #   # # # ##
# ### ### ##### # # # ####### # #                                 ### ##### #####o# # ### ### # # ##
#   #     # #   #     #     # # #                                   #   #   #     #   #   #   # # ##
### ####### ###o# ##### # ### # #                                 # ### # ### #####o###o### ### ####
# #     #   #   # #     #     # #                                 #   # o #   #   # #     o   #   ##
# ##### # # # ##### ##############                                ### ### # # # # # # # ### ##### ##
# #   # # # #     # #                                             # o #   # # # #   o #   #     # ##
# # # # # ####### # #o############                                # # # ### # # ######### ##### #o##
# # # # #       #   #     #                                       # # #   # # # #   o   #   #     ##
# # # # ###o############# # ######                                # # # ### # # ### # # # # ##### ##
#   # # # o   o #       o                                           #   #   # #     # # # #   #   ##
# ### # # # # # # ###o###########                                 ####### ############# # ### ### ##
# #   # # # o   # #   #         #                                       #   o       #   #   #   # ##
# # ### # ### ### ### # ####### ##                                ##### # # ### ##### ##### ### # ##
# #   # # # #   #     #     # # #                                     # # # #   #     # #   # # # ##
# ### # # # ### # ###o##### # # ##                S               # # # # ### # # ##### # ### # ####
#   #   # # #   # # #   #       o                                 # # # #     # # #       #   #   ##
### ##### #o# ### # # ### ########                                # # # ###o### # ##### ### # ### ##
# #     # #   #     #   # #     #                                 # # # # # #   #     #   # #   # ##
# ##### # # ### ##### # #o# ### ##                                # # # # # ### ##### ### ### ### ##
#   o # # # #       # #   #   #                                   #   # #   #   o  G# # #     #   ##
# ### # # #o###o# # ### # ### ####                                #o### #o### # ### # # #C### # # ##
#   #   # #     # #   #     # #                                     #   # #   #   # # #     # # # ##
### ##### ####### ###o####### #G##                                # # ### # ##### # # # ##### # # ##
#   # #   o #     #           #                                     # o #   #   #   # #       # # ##
# ### # # # ####### # ###########                                 # # # ##### ### #o# ##### ### ####
#   # # # # #       #   #     #                                   # # # # o       # #   # # # #   ##
### C # # # # ######### # ### # ##                                # # # # ######### ### # # # ### ##
#   # #     #   #     o   #   #                                       # # #       #   # o #   #   ##
# ### ###o##### ### ### # #######                                 ##### ### ##### ###o### ##### # ##
#   o     #   #     #   #   #                                       #   #   #   # #   # # #   # # ##
##### ##### ######### ##### # ####### # # # # ### #######o# ###o### # ### ### # #o# # # # # # # # ##
#       o #     o     #   # # #       # # # #     # #     #     #     #   #     o   # o # # #   # ##
### # # # # ### ######### # # ### ##### ### ####### # ##### ############# ##### ### ##### # ########
#   # # #   # # #   o     # #   # #         #   #   #   #   #   #   #     o # #   # #   # # #     ##
# ### # ##### ####### ### # ### # ### #######o# # # ### ##### # # # # ### # # ###o# # # # # #o### ##
#   # #     #         # o #     #   # #   #   #   #   #         # # #   # # #       # #   # o   # ##
### # ##### ##### ##### #########o### ### # #o####### #######o# # # ###o# # # ####### ########### ##
#   #   #   #     # #   # o   #   # #   #   # # #   #       # # # #       # #   #     # #     #   ##
# ##### # ### ##### # ### # ### ### ### ### ### # # # ####### ### #######o# ##### ##### # # # # # ##
# #   o #     # #   # #   #     #     #   # o   # #           #   #       # o   #     # # # #   # ##
# ### ######### # # # ###o######### ##### # ##### # #o### ##### ### ##### # ### ##### #o# # ########
#   # #         # # #     #   o   o o   o # #   o   #   # #   o #   #     # #   #   # # C # #   o ##
# # # # # ### ### # #######o# # ### ### ##### ### ##### ###o# ###o# ######### ### #o#o### # #C# # ##
# # # # #   # #   #           #G  #   #   #   # # # #   #   #   o #         #     #     # #   # # ##
# # ### ### # # ####### ###o##### ### ### # ### #o# # ### # # # # ######### ####### # # # ####### ##
# #   #   # # #   #   # #   #       #   # # #       # #   #   # #         # #     o   o #   #   o ##
# ### ### # ##### # # ### ### ##### ###o# # ### # # # # ### #############o# # ### # ######### ### ##
# # #     #     o #     # #     #   o   # #   #   # #   #       #       #   #   # #           # # ##
# # #################o# # ###o### #o### # ### ##### ##### ### ### ###o### #o### ############### # ##
#  G      #   #   # # # o     #   #     #     #     #   # #   o   #   o #   o #                 # ##
######### # ### # # # ### # ### ############### ##### # # # ######### # # ### ### ############# # ##
#     #     #   # o   # # #     #   #       #   #   # # o #   #       #   o #   #       #       # ##
##### # ##### ######### # ######### # ### ### ### # # ###o### # ##### ##### ### ####### # ####### ##
# #   # # #   #   o #   #     o   # # # #   #     #   # #   #   #   # #   o           # #   #   # ##
# # # # # # #C### # # ######### ### # # ### ########### # ####### # # ### #o####### ### # ### # #o##
#   # # # #     # # #         #   # #   # # #           # #     # # #   # #   o #   #   # #   #   ##
#o### # # ##### # # ######### ### # ### # # # ######### # # ### # ##### # ### # ##### ##### ##### ##
# #   #     # #   # #     #     # # o # # # #   # o   # #   # # #   #     o # #   #   #   #   # o ##
# ######### # ##### # ### # ##### # # # # # ### # # # # ##### # ### # ##### ### # # ### # ### # # ##
#G        #   #     #   # # o       # #   #     # # # # #     #   #     # #   # # #     #     # # ##
# ##### ##### # ####### # ##### ######### ####### ### # # # ##### # ##### #o# ### ############# # ##
#     #       #         #       o       o         #   #   #       o     o   #       o     o     # ##
####################################################################################################
####################################################################################################
