####################
# #         #     ##
# ###C### ### ###o##
#   #G  #         ##
###o####C######o# ##
#         #     C ##
#o# ##### # ##### ##
#   #         #   ##
##### #       ##C ##
#     #         # ##
# #####   S   # ####
# #   #       #C  ##
#C# # #       ### ##
# # #   o   #   # ##
# # ### ### ### # ##
#C#  C# o # o # # ##
# ### ### # # #C# ##
#   #   G #GC     ##
####################
####################
