####################
#   # #      G G  ##
### # # ####### ####
# #G# # #   # o   ##
# # # #o# ### # ####
# # #G    C   #   ##
# # ####### ######C#
#   #         #   ##
# ### #       # # ##
# #   #      C  # ##
# ### #   S  #C## ##
# #   #        C  ##
# # ###       ### ##
#   # # #   oC  # ##
##### # # ### # ####
# o  C#   #   #G  ##
# #########C# ### ##
#             o   ##
####################
####################
