###################################################################################################
#         #             #                 # #         #       # #         #   #       #       #   #
######### ### # ####### # ##### ######### # # ##### # # ##### # # ### ### # ### ##### # ### # # # #
#       #   # #   #   # #     #   #     # # # #   # #   #   # # #   # #   # #   #   # # # # #   # #
# ##### ### ##### ### # ######### ### ### # # # # # ##### ### # ### # ### # # ##### # # # # #######
# #   #   #   #   #   #     #   #   #   # #   # #   #   #     # #   #   # # # #     # # # # #     #
# ### ### ### # ### # ##### # # ### ### # ##### ##### # # ##### # ##### # # # ### # # # # # # ### #
#     #     # # #   #     #   #     #   #   #   #   # # #   #       #   # # #   # # #     #   #   #
##### # ### # # # # ### ############# # ### # ##### # # ### ######### ### # ### # ############# # #
# #   # #   #   # #   # #   #   #     # # #   #     # #   #         # #   #   #   #     #       # #
# # ### # ####### ### ### # # # # ### # # ##### ### # # ########### # # ##### # ### ### # ####### #
# #   # # #     # # #     #   # # # # #   #     #   # #       #   #   #     #   #   #   # #       #
# ### # ### # ### # ##### ##### # # # ##### ### ##### ### ### ### ######### ##### ##### # # #######
#     #     #       #   #     #   # #       # #         # # #   #   #     #     #     # # #   #   #
# ################# # # ##### ##### ######### ########### # ### # # ### # ##### # ### # # ##### # #
#         #       # # #   #         #           #   #     #   #   #     # #   # #   # #   #     # #
##### ##### ##### # # ### # ####### ### ####### ### # ##### # ########### # # # ### # ##### ##### #
#     #     #   # # # # # # #   #   #   #     #     # # #   #     #     # # # #   # #     #     # #
####### ####### # ### # # ### # # ### ### # # ##### # # # # # ##### ### # # # ### ### ### ### ### #
#   #   #       #     # #     # #   #   # # #     # # #   # # #     #   #   # # #   #   #     #   #
# # # ### ### ######### ####### ### ### # # ##### # # ##### ### ##### # ##### # ### ########### # #
# #   # # # #           #     #   #   # # # #     # #     #     #   # #     # #   #       #     # #
# ##### # # ######### ### ### ### ### # ### ####### ##### ### ##### # ##### # ### ####### # ##### #
# #     #   #   #   # #     #   # #   # #   #           #   #       # #     #   #   #     #   # # #
# # ### ### # # # # # # ####### # # ### # ### ############# ####### # ######### # # # ####### # # #
# # #     # # #   # #     #     # #     #       #           # #     #         # # # #   #     #   #
# ### ##### ####### ####### ##### ##### ######### ########### # ########### ### # # ### # ##### ###
#   #           #     # #   #     # #   #   #   #     #   #   # #     #   # #   # # #   # #   # # #
# # ########### # ### # # ### ##### # ### # # # ##### ### # # # # ### # # # # ##### # ### # ### # #
# # #         #   # # # #     # #     #   #   #     # #   # # #   # #   # #   #     # #   #     # #
### # ####### ##### # # ####### # ##### ########### # # ### # ##### ##### ##### ### # # ### ##### #
#   # #     #     #     #   #   # # #   #     #   #   #     #       #   #   #   #   #   #   #     #
# ### # ######### ##### # # # # # # # ### # # # # ##### ####### ### # ##### # ### ####### ##### # #
#     # #     # #   #   # # # #     # #   # # # #     #   #   # # # #     #   #   #     #     # # #
# ##### # # # # ### ### # # ######                                # ##### ##### ### # ####### # ###
#   #     # #     #   # # #                                         #   #   #   # # # #     # #   #
### ####### ######### # # #######                                 # # # # # # ### # # # ### # # # #
#   #   #   #   #     # #   #                                     #   #   # #     # #   # # # # # #
# ### # # ### # # ##### # # ######                                # ############# # ##### # # ### #
#     # #     # # #   # # #                                       # #             # #     #   #   #
####### # ##### # ### # #########                                 ### ############# # # # ##### # #
#     # #   #   #   # # #   #                                         #   #   #   # # # #       # #
# ##### ##### ##### # # # # # ####                                ##### # # # ### # # # ##### #####
# #   #   #   #   # #     #   #                                         #   #     # # # #     #   #
# # # ### # ### # # ####### #####                                 ### ############# # # ####### # #
#   #     # #   # #   #   # #   #                                 # # #             # #         # #
# ######### # ### ### # # ### # ##                                # # # ############# ##### ##### #
# #         #   # #   # #     # #                                 #   # # #         # #   #     # #
# # ####### ### # # ### ####### #                                 # ### # # ##### # # # # ####### #
# #   # #   # # #   #     #     #                                 # #   #   #   # # # # #         #
# ### # # ### # ##### ##### #####                                 # # ### ### # # ### # ######### #
#   # #   #   #       #   # #                                       #   # #   # #     # #         #
### # # ### # ######### # # # ###                                 ##### # # ### ####### # #########
# #   # #   #         # #   # # #                                 #     # #   #     #   #   #     #
# ##### ### ####### ### ##### # #                                 # ######### ##### # ##### # ### #
#     #   # # #   # #   # #     #                                   #         #   # #     # # #   #
# # # ### # # # # # # ### # ######                                ### # ######### # ##### # ### # #
# # #   # #   # #   #   # # # #                                   #   #   #       # #     #     # #
# # ### # ### # ####### # # # # ##                                # ##### # ####### # ########### #
# #   # #   # # #   #   #     # #                                 # #   # # #         #     #   # #
# ### ##### ### # # # ######### #                                 # # # # # # ######### ### # # # #
#   #     #   #   # #       #   #                                 #   # # #     #         # # # # #
### ##### ### ##### ####### # ###                                 ##### # ####### ######### # # # #
# # #   # #   #         #   # #                                     # # #         #     #   # # # #
# # # # # # ### # ####### ### # ##                                # # # ####### ### ### # ### ### #
#   # # # #     # #       #   # #                                   # # #     # #   #   #   #     #
# ##### # ####### # ##### # ##### # # ### # ##### # # # # # # ####### # # ### ### ### ##### # #####
#     # #   #     # #   # #     # # #   # #     #   #   # # #     # #   # #     #   #       #     #
##### # # ### ##### # ### ##### # # ### # ##### # ##### # ####### # # ### ##### # # ############# #
#   #   #     #   # #       # # # #   # # #   # # #     #     # # # #   #     # # # # #         # #
# # ### ######### # ####### # # # ### # # ### # ### ####### # # # # ### ##### # ### # # ##### ### #
# #   # #       # #     # #   #   #   # #   # # #   #       # # # #   #   #   #     # # #   #   # #
### # # ##### # # ##### # # ####### ### ### # # # ### ####### # # # ### ### ######### # # # ### # #
#   # #   #   # # #   # #   #     # #   #   # #   # # #     # # # #   # #   #     #       # #   # #
# ####### # ### # # # # # ### # ### ### # ### ##### # ### # # # # ### # # ##### ### ######### ### #
# #   #   # #     # #   # #   #   #     #         # #   # #     #   #   # #   #       #     #   # #
# # # # ### ####### ### ### ##### ############### # ### ########### # ### # # ####### # ### ### # #
# # #       #   #   #   #     #       #         # #   #       #     # # #   #     # # # # # #   # #
# # ######### # # ####### ##### ##### # ##### ### # ######### # ##### # ##### ### # # # # # # ### #
# # #       # # #           #   #   #   # #   #   #         # #   #     #   #   # #   # #     #   #
# # # ##### # # ########### # ### # ##### # ### ### ####### # ### ####### # ##### ##### ####### ###
#   # #   #   # #         # #   # #   #       # #   #     # #     #     # #       #   #           #
# ### # ####### # ####### # ### ### # # ####### # ### ### # ####### ### # ### ##### # ##### #######
# #   #       # # #     # #   #   # # # #   #   #   # #   #         #   #   # #     # #   #   #   #
# # ### ### ### # # ### # ####### # # # # # # ##### # ### ### ####### ##### ### ##### # # ##### # #
# #   #   #     # #   # #         # #     # # #   # #   #   # #           #     #   #   #       # #
# ### ### ####### # # ########### ########### # # # ### ### # ########### ### ##### ######### ### #
# #   # # #       # #           # #       #   # #     #   # #           #   #       #       #   # #
### ### # # ####### ######### ### # ##### # ######### # # # ########### ### ##### ### ##### ##### #
#   #     # #     #   #     #     # #   # #       #   # # #   #     #   #   #   # #   #   # #   # #
# ##### ### # ####### ##### ####### ### # ####### ### ### ### # ### # ### ### ### # ##### # # # # #
# #   # #   #               #     #   # #       #   #   # #   # #   # # # #   #   # #     # # # # #
# # # # # ##### ########### ##### ### # ##### # ### ### # # ### # ### # # ### # ### ### # # # # # #
# # # #   #   #     #     #         # # #     # #   #   # #     # #   # #   #   #   #   # #   # # #
# # # ##### # ##### # ### ######### # # # ##### # ##### # ######### ### ### ##### ### ######### # #
#   #   #   # #   # #   #   #       # # #   #   # #   #   #   #   # # #   #   #   # #   #     # # #
# ##### # ### # # ##### ### ######### # ### ##### # # ##### # # # # # # # ### # ### # # # ### # # #
#     #     #   #         #               #         #       #   #   #   #       #     #     #     #
###################################################################################################
