##########
# #     ##
# # # # ##
# # # #G##
#o##  # ##
#    S# ##
# # # #G##
#G#GC  G##
##########
##########
