####################
# #   #  C#     # ##
# # ###G# #C# C # ##
# #   G #   # # # ##
# ##########C # # ##
#     # C     # # ##
##C## # ####### # ##
#  G#         #   ##
# # ##C      #### ##
# #           #   ##
# ####C   S   # ####
#     #       # # ##
#####o#       # # ##
# #     # #   #   ##
# ##### # ### ### ##
#       #C  o #  C##
# ######### #o# ####
#         # #     ##
####################
####################
