####################
# #   #           ##
# ### ####### ###G##
# # o   #   # #   ##
# # ##C # # ### ####
# # C #   #   #   ##
# # # ####### # # C#
# # # #       # # ##
#C# # #      #### ##
# # #           #C##
# #####   S  ## # ##
#   #          C# ##
### # #      ## # ##
# #   #       #C# C#
# ##### # ### # # ##
#     # # #   # # ##
# # ### # # ### # ##
# # G   #  G#     ##
####################
####################
