####################
# #               ##
# ### ##### ##### ##
#   #   # #   #  C##
### ##### ### ######
# #CC   #   #     ##
# ##### #o# ##### ##
#     #         # C#
# ### #      ## #o##
# #   #      G# # ##
# # # #   S  C# # ##
# # # #      G# # ##
### #C#      ## # ##
#   # # #   #   # ##
# ### #CC ###C###C##
# #    G# #   #   ##
# ######### ##### ##
#         G       ##
####################
####################
