####################
#  C      o     # ##
########### # # # ##
# #     #   # #   ##
# # ### # # #C### ##
# #   #   # # #   ##
# ### ##### # # ####
#   # #       #G# ##
# # # #       # # ##
# #  C        #G  ##
# #####   S   ### C#
# #           # # ##
# # ###       # # ##
# #C#     #   # # ##
# #o### # # ### # ##
#   #   # CC# #  G##
# # # ### # # # ####
# #   # G   # o   ##
#############C####C#
####################
