####################
# #       #       ##
# ##### # # ### # ##
#     # #G  #   # ##
#####o### ### ### ##
# #   C oC#G#   # ##
# # # ### # # # ####
#   # #       #   ##
# ### #       ###C##
#   #           # ##
### C##   S  C#o# ##
# # #        C    ##
# # # #      ##o####
# # #         #   ##
# # #o### ### # # ##
# # #  G#G  # # # ##
# #o#####o### ### ##
#    C    #  G    ##
##########C#########
####################
