####################
# #   #     C     ##
# # ###o######### ##
#C#     #     # #G##
# ##### # ###o# # ##
#   # # # #G    # ##
### C # # ##### # ##
#   #         # # ##
# ### #       ### ##
# #   o       C   ##
# ###C#   S  #######
# #   #           ##
# # # #       ### ##
#   #   #G#C    # ##
####### # ### ### ##
#   o # o   # #   ##
# # # ##### ### # ##
# # #      G   C# ##
####################
####################
