###############
#   #         #
### # ####### #
#   #   #     #
# ##### ##### #
# #     #   # #
# ###     # ###
#   #     #   #
### ##    ### #
#   #         #
# ### ####### #
# #   #   #   #
# # ### # # ###
#   #   #     #
###############
