###############
#   #         #
### # ####### #
#   #   #     #
# ##### ##### #
# # G   #   # #
# ###     # ###
#   #  G  #   #
### ##    ### #
#   #  G      #
# ### ####### #
# #   #   #   #
# # ### # # ###
#   #   #     #
###############
