###############
#   #         #
### # ####### #
#   #   #     #
# ##### ##### #
# #     #   # #
# ###  G   # ###
#   #     #   #
### ## G   ### #
#   #         #
# ### ####### #
# #   #   #   #
# # ### # # ###
#   #   #     #
###############
