###############
#   #      S  #
### # ####### #
#   #   #  S  #
# ##### ##### #
# #  S  #   # #
# ###  S  # ###
#   #  C S#  S#
### ##  S ### #
#   # S  S SS #
# ### ####### #
# #   #   #   #
# # ### # # ###
#   #   #  S  #
###############
